George Washington|Father of the United States

Augusto Pinochet|Augusto José Ramón

Dag Hammarskjöld|Dag Hjalmar Agne Carl Hammarskjöld

Françoise Sagan|Françoise Quoirez|Francoise Sagan

Erick Barrondo|Erick Bernabé Barrondo García

André-Pierre Gignac|André-Pierre Christian Gignac, Franchute, Montes jr.

Coluche|Michel Gérard Joseph Colucci

Richard von Weizsäcker|Richard Karl Freiherr von Weizsäcker

Franciszek Karpiński|Franciszek Karpinski

Michel Platini|Michel François Platini

Eugen Polanski|Bogusław Eugeniusz Polański

Abu Nuwas|Abū Nuwās al-Ḥasan ibn Hānī al-Ḥakamī|Abū Nuwās

Philippe Pétain|Henri Philippe Benoni Omer Joseph Pétain|Marshal Pétain

Caterine Ibargüen|Caterine Ibargüen Mena

Günter Grass|Günter Wilhelm Grass|Guenter Grass

Marie Curie|Maria Salomea Skłodowska

Ögedei Khan|Ogedei|Yuán Tàizōng

Möngke Khan|Möngke|Yuán Xiànzōng

Muḥammad ibn Mūsā al-Khwārizmī|Al-Khwārizmī|Al-Khwarizmi|Abū ʿAbdallāh Muḥammad ibn Mūsā al-Khwārizmī|Abū Jaʿfar Muḥammad ibn Mūsā al-Khwārizmī

Erwin Schrödinger|Erwin Rudolf Josef Alexander Schröndinger

Örüg Temür Khan|Gulichi|Ugechi Khashikha (?)

Tümen Jasagtu Khan|Tümen Jasaghtu Khan

Maria Höfl-Riesch|Maria Riesch

João d'Espinha|Gao Shensi

Austregésilo de Athayde|Belarmino Maria Austregésilo Augusto de Athayde

Jorge Délano Frederick|Coke

Damià Campeny i Estrany|Damián Campeny|Damia Campeny|Damián Buenaventura Campeny y Estrada|Damián Buenaventura Campeny Estrany|Damián Buenaventura Campeny y Estrany|Damián Campeny y Estrany|Damià Campeny|Damià Campeny Estrany

Georges Lagrange|Serĝo Elgo

José Batlle y Ordóñez|Jose Batlle y Ordonez

Jože Javoršek|Jože Brejc

Émile Durkheim|Emile Durkheim

Émile Boirac|Émile BOIRAC

Daniel González Güiza|Güiza

Ælfric of Abingdon|Ælfric of Wessex

Oscar|Oscar dos Santos Emboaba Júnior

Théophile Cart|Théophile CART

Élisée Reclus|Elisée Reclus|Jacques Elisée

Ryo Takayasu|Ryō Takayasu

Raúl Banfi|Raoul Banfi

Omurbek Babanov|Өмірбек Бабанов|Өмүрбек Бабанов

Knut Johannesen|Knut «Kupper'n» Johannesen

Anker Sørensen|Anker Sorensen

Bolesław Własnowolski|Bolesław Andrzej Własnowolski|Boleslaw Wlasnowolski

Heribert Faßbender|Faßbender

Gaël Bigirimana|Gael Bigirimana

Higinio Uriarte|José Higinio Uriarte y García del Barrio

Sigurd Haakonsson|Sigurðr Hákonarson

Håkon Grjotgardsson|Håkon the Rich

Sat-Okh|Stanisław Supłatowicz

Agustín Sauto Arana|Bata

José Luis Panizo|José Luis López Panizo

Éverton Lopes|Éverton dos Santos Lopes

Leonard Kleinrock|Тоҷикӣ

Rosibel García|Rosibel García Mena

Marie-Jeanne L'Héritier|Marie-Jeanne L'Héritier de Villandon

Leopoldo Saínz de la Maza|Leopoldo Saínz de la Maza Gutiérrez-Solana y Gómez de la Puente

Allan Bé|Allan W. H. Bé

